XXXXXXXXXXXXXXXXXXXXXXXXXXXXXXXXXXXXXXXXX
XOOOOOOOOOOOOOOOOOOOOOOOOOOOOOOOOOOOOOOOX
XOOOOOOOOOOOOOOOOOOOOOOOOOOOOOOOOOOOOOOOX
XOOOOOOOOOOOOOOOOXXXXXOOOOOOOOOOOOOOOOOOX
XOOOOOOOOOOOOOOOOXXXXXOOOOOOOOOOOOOOOOOOX
XOOOOOOOOOOOOOOOOXXXXXOOOOOOOOOOOOOOOOOOX
XOOOOOOOOOOOOOOOOXXXXXOOOOOOOOOOOOOOOOOOX
XOOOOOOOOOOOOOOOOXXXXXOOOOOOOOOOOOOOOOOOX
XOOOOOOOOOOOOOOOOXXXXXOOOOOOOOOOOOOOOOOOX
XOOOOOOOOOOOOOOOOXXXXXOOOOOOOOOOOOOOOOOOX
XOOOOOOOOOOOOOOOOXXXXXOOOOOOOOOOOOOOOOOOX
XOOOOOOOOOOOOOOOOXXXXXOOOOOOOOOOOOOOOOOOX
XOOOOOOOOOOOOOOOOXXXXXOOOOOOOOOOOOOOOOOOX
XOOOOOOOOOOOOOOOOXXXXXOOOOOOOOOOOOOOOOOOX
XOOOOOOOOOOOOOOOOXXXXXOOOOOOOOOOOOOOOOOOX
XOOOOOOOOOOOOOOOOXXXXXOOOOOOOOOOOOOOOOOOX
XOOOOOOOOOOOOOOOOXXXXXOOOOOOOOOOOOOOOOOOX
XOOOOOOOOOOOOOOOOXXXXXOOOOOOOOOOOOOOOOOOX
XOOOOOOOOOOOOOOOOXXXXXOOOOOOOOOOOOOOOOOOX
XOOOOOOOOOOOOOOOOXXXXXOOOOOOOOOOOOOOOOOOX
XOOOOOOOOOOOOOOOOXXXXXOOOOOOOOOOOOOOOOOOX
XOOOOOOOOOOOOOOOOXXXXXOOOOOOOOOOOOOOOOOOX
XOOOOOOOOOOOOOOOOXXXXXOOOOOOOOOOOOOOOOOOX
XOOOOOOOOOOOOOOOOXXXXXOOOOOOOOOOOOOOOOOOX
XOOOOOOOOOOOOOOOOXXXXXOOOOOOOOOOOOOOOOOOX
XOOOOOOOOOOOOOOOOXXXXXOOOOOOOOOOOOOOOOOOX
XOOOOOOOOOOOOOOOOXXXXXOOOOOOOOOOOOOOOOOOX
XOOOOOOOOOOOOOOOOXXXXXOOOOOOOOOOOOOOOOOOX
XOOOOOOOOOOOOOOOOXXXXXOOOOOOOOOOOOOOOOOOX
XOOOOOOOOOOOOOOOOXXXXXOOOOOOOOOOOOOOOOOOX
XOOOOOOOOOOOOOOOOXXXXXOOOOOOOOOOOOOOOOOOX
XOOOOOOOOOOOOOOOOXXXXXOOOOOOOOOOOOOOOOOOX
XOOOOOOOOOOOOOOOOXXXXXOOOOOOOOOOOOOOOOOOX
XOOOOOOOOOOOOOOOOXXXXXOOOOOOOOOOOOOOOOOOX
XOOOOOOOOOOOOOOOOXXXXXOOOOOOOOOOOOOOOOOOX
XOOOOOOOOOOOOOOOOOOOOOOOOOOOOOOOOOOOOOOOX
XOOOOOOOOOOOOOOOOOOOOOOOOOOOOOOOOOOOOOOOX
XOOOOOOOOOOOOOOOOOOOOOOOOOOOOOOOOOOOOOOOX
XOOOOOOOOOOOOOOOOOOOOOOOOOOOOOOOOOOOOOOOX
XOOOOOOOOOOOOOOOOOOOOOOOOOOOOOOOOOOOOOOOX
XXXXXXXXXXXXXXXXXXXXXXXXXXXXXXXXXXXXXXXXX