XXXXXXXXXXXXXXXXXXXXXXXXXXXXXXXXXXXXXXXXX
XOOOOOOOOOOOOOOOOOOOOOOOOOOOOOOOOOOOOOOOX
XOOOOOOOOOOOOOOOOOOOOOOOOOOOOOOOOOOOOOOOX
XOOOOOOOOOOOOOOOOOXXXXOOOOOOOOOOOOOOOOOOX
XOOOOOOOOOOOOOOOOOXXXXOOOOOOOOOOOOOOOOOOX
XOOOOOOOOOOOOOOOOOXXXXOOOOOOOOOOOOOOOOOOX
XOOOOOOOOOOOOOOOOOXXXXOOOOOOOOOOOOOOOOOOX
XOOOOOOOOOOOOOOOOOXXXXOOOOOOOOOOOOOOOOOOX
XOOOOOOOOOOOOOOOOOXXXXOOOOOOOOOOOOOOOOOOX
XOOOOOOOOOOOOOOOOOXXXXOOOOOOOOOOOOOOOOOOX
XOOOOOOOOOOOOOOOOOXXXXOOOOOOOOOOOOOOOOOOX
XOOOOOOOOOOOOOOOOOXXXXOOOOOOOOOOOOOOOOOOX
XOOOOOOOOOOOOOOOOOXXXXOOOOOOOOOOOOOOOOOOX
XOOOOOOOOOOOOOOOOOXXXXOOOOOOOOOOOOOOOOOOX
XOOOOOOOOOOOOOOOOOXXXXOOOOOOOOOOOOOOOOOOX
XOOOOOOOOOOOOOOOOOXXXXOOOOOOOOOOOOOOOOOOX
XOOOOOOOOOOOOOOOOOXXXXOOOOOOOOOOOOOOOOOOX
XOOOOOOOOOOOOOOOOOXXXXOOOOOOOOOOOOOOOOOOX
XOOOOOOOOOOOOOOOOOXXXXOOOOOOOOOOOOOOOOOOX
XOOOOOOOOOOOOOOOOOXXXXOOOOOOOOOOOOOOOOOOX
XOOOOOOOOOOOOOOOOOXXXXOOOOOOOOOOOOOOOOOOX
XOOOOOOOOOOOOOOOOOXXXXOOOOOOOOOOOOOOOOOOX
XOOOOOOOOOOOOOOOOOXXXXOOOOOOOOOOOOOOOOOOX
XOOOOOOOOOOOOOOOOOXXXXOOOOOOOOOOOOOOOOOOX
XOOOOOOOOOOOOOOOOOXXXXOOOOOOOOOOOOOOOOOOX
XOOOOOOOOOOOOOOOOOXXXXOOOOOOOOOOOOOOOOOOX
XOOOOOOOOOOOOOOOOOXXXXOOOOOOOOOOOOOOOOOOX
XOOOOOOOOOOOOOOOOOXXXXOOOOOOOOOOOOOOOOOOX
XOOOOOOOOOOOOOOOOOXXXXOOOOOOOOOOOOOOOOOOX
XOOOOOOOOOOOOOOOOOXXXXOOOOOOOOOOOOOOOOOOX
XOOOOOOOOOOOOOOOOOXXXXOOOOOOOOOOOOOOOOOOX
XOOOOOOOOOOOOOOOOOXXXXOOOOOOOOOOOOOOOOOOX
XOOOOOOOOOOOOOOOOOXXXXOOOOOOOOOOOOOOOOOOX
XOOOOOOOOOOOOOOOOOXXXXOOOOOOOOOOOOOOOOOOX
XOOOOOOOOOOOOOOOOOXXXXOOOOOOOOOOOOOOOOOOX
XOOOOOOOOOOOOOOOOOOOOOOOOOOOOOOOOOOOOOOOX
XOOOOOOOOOOOOOOOOOOOOOOOOOOOOOOOOOOOOOOOX
XOOOOOOOOOOOOOOOOOOOOOOOOOOOOOOOOOOOOOOOX
XOOOOOOOOOOOOOOOOOOOOOOOOOOOOOOOOOOOOOOOX
XOOOOOOOOOOOOOOOOOOOOOOOOOOOOOOOOOOOOOOOX
XXXXXXXXXXXXXXXXXXXXXXXXXXXXXXXXXXXXXXXXX