XXXXXXXXXXXXXXXXXXXXXXXXXXXXXXXXXXXXXXXXX
XOOOOOOOOOOOOOOOOOOOOOOOOOOOOXOOOOOOOOOOX
XOOOOOOOOOOOOOOOOOOOOOOOOOOOOXOOOOOOOOOOX
XOOOOOOOOOOOOOOOOOOOOOOOOOOOOXOOOOOOOOOOX
XOOOOOOOOOOOOOOOOOOOOOOOOOOOOXOOOOOOOOOOX
XOOOOOOOOOOOOOOOOOOOOOOOOOOOOXOOOOOOOOOOX
XOOOOOOOOOOOOOOOOOOOXXXXXXXXXXOOOOOOOOOOX
XOOOOOOOOOOOOOOOOOOOOOOOOOOOOOOOOOOOOOOOX
XOOOOOOOOOOOOOOOOOOOOOOOOOOOOOOOOOOOOOOOX
XOOOOOOOOOOOOOOOOOOOOOOOOOOOOOOOOOOOOOOOX
XOOOOOOOOOOOOOOOOOOOXOOOOOOOOOOOOOOOOOOOX
XOOOOOOOOOOOOOOOOOOOXOOOOOOOOOOOOOOOOOOOX
XOOOOOOOOOOOOOOOOOOOXOOOOOOOOOOOOOOOOOOOX
XOOOOOOOOOOOOOOOOOOOXOOOOOOOOOOOOOOOOOOOX
XOOOOOOOOOOOOOOOOOOOXOOOOXXXXXXXXXXXXXXXX
XOOOOOOOOOOOOOOOOOOOOOOOOOOOOOOOOOOOOOOOX
XOOOOOOOOOOOOOOOOOOOOOOOOOOOOOOOOOOOOOOOX
XOOOOOOOOOOOOOOOOOOOXOOOOOOOOOOOOOOOOOOOX
XOOOOOOOOOOXXXXXXXXXXOOOOXXXXXXXXXXXXXXXX
XOOOOOOOOOXOOOOOOOOOOOOOOXOOOOOOOOOOOOOOX
XOOOOOOOOOXOOOOOOOOOOOOOOXXOOOOOOOOOOOOOX
XOOOOOOOOOXOOOOOOOOOOOOOOOXOOOOOOOOOOOOOX
XOOOOOOOOOXOOOOOOOOOOOOOOOXOOOOOOOOOOOOOX
XOOOOOOOOOXOOOOOOOOOOOOOOOXOOOOOOOOOOOOOX
XOOOOOOOOOXOOOOOOOOOOOOOOOXOOOOOOOOOOOOOX
XXOOOOXXXXXOOOOOOOOOOOOOOOXOOOOOOOOOOOOOX
XOOOOOOOOOOOOOOOOOOOOOOOOOOOOOOOOOOOOOOOX
XOOOOOOOOOOOOOOOOOOOOOOOOOOOOOOOOOOOOOOOX
XOOOOOOOOOOOOOOOOOOOOOOOOOOOOOOOOOOOOOOOX
XOOOOOOOOOOOOOOOOOOOOOOOOOOOOOOOOOOOOOOOX
XOOOOOOOOOOOOOOOOOOOOOOOOOOOOOOOOOOOOOOOX
XOOOOOOOOOOOOOOOOOOOOOOOOOOOOOOOOOOOOOOOX
XOOOOOOOOOOOOOOOOOOOOOOOOOOOOOOOOOOOOOOOX
XOOOOOOOOOOOOOOOOOOOOOOOOOOOOOOOOOOOOOOOX
XOOOOOOOOOOOOOOOOOOOOOOOOOOOOOOOOOOOOOOOX
XOOOOOOOOOOOOOOOOOOOOOOOOOOOOOOOOOOOOOOOX
XOOOOOOOOOOOOOOOOOOOOOOOOOOOOOOOOOOOOOOOX
XOOOOOOOOOOOOOOOOOOOOOOOOOOOOOOOOOOOOOOOX
XOOOOOOOOOOOOOOOOOOOOOOOOOOOOOOOOOOOOOOOX
XOOOOOOOOOOOOOOOOOOOOOOOOOOOOOOOOOOOOOOOX
XXXXXXXXXXXXXXXXXXXXXXXXXXXXXXXXXXXXXXXXX